{
  "name": "Test Map",
  "width": 20,
  "height": 31,
  "startPositions": [15, 16, 17, 18],
  "map": [
    "00-00-00-00-03-03-03-03-03-03-03-03-03-03-03-03-03-03-03-03",
    "03-00-00-00-03-03-03-03-03-03-03-03-03-03-03-00-03-03-00-00",
    "03-03-00-00-00-03-03-03-03-03-03-03-03-03-03-00-03-03-03-03",
    "03-03-03-00-00-00-03-03-03-03-03-03-03-00-00-00-00-03-03-03",
    "03-03-03-00-00-01-01-03-03-03-03-03-03-04-00-04-03-03-03-03",
    "03-03-03-00-00-01-00-03-03-03-03-03-03-04-00-04-03-03-03-03",
    "03-03-03-00-00-00-00-03-03-03-03-00-00-00-00-03-03-03-03-03",
    "03-03-03-00-00-00-03-03-03-03-00-00-00-00-03-03-03-03-03-03",
    "03-03-03-03-00-00-03-03-03-03-00-00-00-00-03-03-03-03-03-03",
    "03-03-03-03-00-00-01-03-03-04-00-00-04-03-03-03-03-03-03-03",
    "03-03-03-03-00-00-00-03-03-04-00-00-04-03-03-03-03-03-03-03",
    "03-03-00-00-00-00-00-00-03-00-00-00-00-01-03-03-03-03-03-03",
    "03-03-00-00-00-00-00-00-00-00-00-00-00-03-03-03-03-03-03-03",
    "03-00-00-00-00-00-00-00-00-00-00-00-00-00-00-00-03-03-03-03",
    "00-00-04-04-04-04-04-00-00-00-00-00-00-00-00-00-03-03-03-03",
    "00-00-04-00-00-00-04-01-03-03-00-00-03-03-01-00-03-03-03-03",
    "00-00-04-00-00-00-04-00-03-00-00-00-00-00-03-03-03-03-03-03",
    "00-00-04-04-00-04-04-01-03-00-00-00-00-03-00-03-00-00-03-03",
    "00-00-04-04-00-04-04-01-03-00-00-00-00-00-00-00-00-00-03-03",
    "00-00-00-00-00-00-00-00-03-03-00-00-00-00-00-00-03-00-03-03",
    "00-00-00-00-00-00-00-00-03-01-03-03-03-03-03-00-03-03-03-03",
    "03-03-00-03-03-03-00-03-03-00-00-00-00-00-00-00-00-00-03-03",
    "03-03-00-00-00-00-00-00-03-03-03-00-00-00-00-00-00-00-03-03",
    "03-03-03-00-00-00-00-00-03-03-03-03-00-00-00-00-00-00-03-03",
    "03-03-03-03-03-03-03-00-00-03-03-03-03-00-00-00-00-00-03-03",
    "03-03-03-03-03-03-03-03-00-00-03-03-03-00-00-00-00-00-00-03",
    "03-03-03-03-03-03-03-03-00-00-03-03-03-00-00-00-00-00-00-00",
    "03-03-03-03-03-03-03-03-00-00-00-03-03-00-00-00-00-00-00-00",
    "03-03-03-03-03-03-03-03-03-00-00-00-00-00-00-00-00-00-00-00",
    "03-03-03-03-03-03-03-03-03-03-00-00-00-00-00-00-00-00-00-00",
    "03-03-03-03-03-03-03-03-03-03-03-00-00-00-00-00-00-00-00-00"
  ]
}
